
NO ./xpm/north.xpm

SO ./xpm/south.xpm

WE ./xpm/west.xpm

EA ./xpm/east.xpm

F 220,100,0

C 225,30,0

1111
1E01
1001
1111