
NO ./xpm/poop.xpm

EA ./xpm/yonghyle.xpm
SO ./xpm/south.xpm

WE ./xpm/west.xpm


F 220,100,0

C 225,30,0

1111111111111111111111
1001100000111000000001
100111100111000E100111 
100111100011100000111111
1000011100000000000111
1111111111111111111111111